 _________ 
| |   |   |
| | | | | |
| | | | | |
| | | | | |
|___|___|_|
